----------------------------------------------------------------------------------------------------------------
----------------------------------------------------------------------------------------------------------------
----------------------------------------------------------------------------------------------------------------
----------------------------------------------------------------------------------------------------------------
----------------------------------------------------------------------------------------------------------------
------------Q------------------------------XX-------------------------------------------------------------------
------------------------------------------XXX-------------------------------------------------------------------
-----------------------------------------XXXX-------------------------------------------------------------------
----------------------------------------XXXXX-------------------------------------------------------------------
------Q---S?SQS--------SSQS------------XXXXXX-------------------------------------------------------------------
--------------------------------------XXXXXXX------------------X---------X---------X----------------------------
------------------<>--------------<>-XXXXXXXX------------------X---------X---------X----------------------------
-----------E------[]---------EE---[]XXXXXXXXX------------------X---------X---------X--------------X---------F---
XXXXXXXXXXXXXXXXXXXXXXXXXXXXXXXXXXXXXXXXXXXXXXXXXXXX----XXXXXXXX--XXXXXXXX--XXXXXXXX--XXXXXXXXXXXXXXXXXXXXXXXXXX
