---------------------------------------------------------------------------------------------------------------
---------------------------------------------------------------------------------------------------------------
----------------------------------------------------------------------------------------------------------E----
---------------------------------------------------------------------------------------------------------------
---------------------------------------------------------------------------------------------------------------
---------------------------------------------------------------------------------------------------------------
---------------------------------------------------------------------------------------------------------------
-----------------------------------------------------------------------------------B---------------------------
---------------------------E--S--------o-------------------------------------------b---------------------------
--------------------------<>-----E------------------------QQQQ-------------------SSXSS----------E--------------
------------X-------------[]----<>-------------------------------B-----E---B-------------------<>--------------
--------E---X-------------[]----[]---------------------B--E------b---------b-----------B-------[]--------------
------------X---EE-E--E---[]----[]----------E----E-----b-------------------B-----------b-------[]----------F---
XXXXXXXXXX--XXXXXXXXXXXXXXXXXXXXXXXXXXXXXXXXXXXXXXXXXXXXXXXXXXXXXXXXXXXXXXXXXXXXXXXXXXXXXXXX--XXXXXXXXXXXXXXXXX
