------------------------------------------------------------------------------------------------------
------------------------------------------------------------------------------------------------------
S-------SSSSSSSSSSSSSSSSSSSSSSSSSSSSSSSSSSSSSSSSSSSSSSSSSSSSSSSSSSSSSSSSSSSSSSSSS---------------------
S-----------------------------------------------------------------------------------------------------
S----------------------------------------------------------------------------------XXX----------------
S-----------------------------------------------------------------------------------------------------
S--------------------------------o--------------------------------------------------------------------
S-----------------------------------------------------------------------------------------------------
S-------------------------------S-----------------S-------------------------------------SS------------
S------------QQQQQ--------XXXX------------------E----E-----------E-------------XXX-----------S--------
S-----------------------XXXXXXXX--XX-----------<>---<>----------<>------------EXXX-XXX----------------
S---------------------XXXXXXXXXX--XXXX---------[]---[]----------[]----------EXXXXX--------------------
S----------------EE-XXXXXXXXXXXXE-XXXX---------[]---[]---E-EE---[]----------XXXXXX----------------F---
XXXXXXXXXXXXXXXXXXXXXXXXXXXXXXXXXXXXXXXXXXXXXXXXXXXXXXXXXXXXXXXXXXXXXXXXXXXXXXXXX-------XXXXXXXXXXXXXX
