------------------------------------------------------------------------------------------------------------------------------------------------------
------------------------------------------------------------------------------------------------------------------------------------------------------
S-----SSSSSSSSSSSSSSSSSSSSSSSSSSSSSSSSSSSSSSSSSSSSSSSSSSSSSSSSSSSSSSSSSSSSSSSSSSSSSSSSSSS?SSSSSSSSSSSSSSSSSSSS-------SSSS-----SSSSSSSSSSSSSSSSSSSSSSSS
S-----------------------------------------------------SS--SSSSSS--SSSS------SSSS----------------------------------------------------------------------
S-----------------------------------------------------SS--SSSSSS--SSSS--E---SSSS--------------------------------------?-------------------------------
S----------------------------------------oooo-------SS--------SS---S----SS----------oooooo---------------------------S??------------------------------
S-----------------------------o---------------------SS--------SS---S----SS------------------------------------------------XXX-------------------------
S--------------------------------------S-SSSS-S-----SS--------SS---S----SS----------SSSSSS------------------------------------------------------------
S----------------------------S---------SoS--SoS-----SS----ooooSS---So??-SS---E------SSSSSS----------------E----------------------------------E--------
S---------QQQQQ--------XXXX------------SSS--SSS-----SSSS--SSSSSS---SSS--SS--SSSS-------------------------<>------XXX-SSSS----------------E--<>--------
S--------------------XXXXXXXX--XX---------------------SS-------------------EE-------------------------XX-[]--XXX------------------E-----<>--[]--------
S------------------XXXXXXXXXX--XXXX-------------------SS---------------------------------------------XXX-[]--XXX-----------------<>-----[]--[]--------
S-------------EE-XXXXXXXXXXXXE-XXXX-------EE---------E------E--E---------------------------------E-E-XXX-[]--XXX-----------------[]---E-[]--[]--------
XXXXXXXXXXXXXXXXXXXXXXXXXXXXXXXXXXXXXXXXXXXXXXXXXXXXXXXXXXXXXXXXXXXXXXXXXXXXXXXX---XXXXXXXXXXXXXXXXXXXX--XX--XX------XXXX------XXXXXXXXXXXXXXX--XXXXXX
