----------------------------------------------------------------------------------------------------
--------------------XX---------------------------------------------------XXXX-----------------------
S-----------SSSSSS-------S----------------SSSSSSSSSSSSSSSSSSSSSSSSSSSSSS-------SSSSSSSSSSSSSSSSSSSSS
S------------------------S------------------SSS--------------------------------SSSSSSSSSSSSSSSSSSSSS
S------------------------S------------------SSS--------------------------------SSSSSSSSSSSSSSSSSSSSS
S-----------------------XS-------------SSS-------------------------------------SSSSSSSSSSSSSSSSSSSSS
S------------------------S---------------------------------------o----o--------S--------------------
S------------------------S-------------S---------------------------------------S--------------------
S------------------------S----SSSSSSSSS-S---oo??----------------S----S----------?oooooooooooooooooo-
S------------------------S---------------S--SSS---------------X-----------------??SSSSSSSSSSSSSSSSS-
S----------------XXX-----S-----------------------------------XXX--XXX--XX---------------------------
S------------EXXXXXXXX---S--------------------------------EXXXXX--XXX--XXXXXX-----------------------
S------------XXXXXXX-----S------E-E--E----------------E---XXXXXXE-XXXE-XX---------------------------
XXXXXXXXXXXXXXXXXXX-----XXXXX-XXXXXXXXXXXXXXXXXXXXXXXXXXXXXXXXXXXXXXXXXX-------XXXXXXXXXXXXXXXXXXXXX
