--------------
--------------
S-----SSSSSSSS
S-------------
S-------------
S-------------
S-------------
S-------------
S-------------
S---------QQQQ
S-------------
S-------------
S-------------
XXXXXXXXXXXXXX
-------------X
-------------X
-------------X
-------------X
-------------X
-------------X
-------------X
-------------X
------------FX
-------------X
-------------X
-------------X















