------------------------------------------------------------------------------------------------------
------------------------------------------------------------------------------------------------------
------------------------------------------------------------------------------------------------------
----------------------XX------------------------------------------------------------------------------
------------E---------XX------------------------------------------------------------------------------
-----------SQS--SQS---XX------------------------------------------------------------------------------
----------------------XX------------------------------------------------------------------------------
----------------------XX------------------------------------------------------------------------------
----------------------XX--------------------------------------------ooo-------------------------------
-----------SQS--S?S---XX---------E--S----------E------------------E----------------------S------------
----------------------XX--------<>------------<>-----------------<>-----------------------------------
----------------------XX--------[]------<>----[]-----------------[]-------------X---------------------
---------E-----E------XX--------[]-E----[]----[]-----------------[]-------------X-------EE--------F---
XXXXXXXXXXXXXXXXXXXXXXXXXXXXXXXXXXXXXXXXXXXXXXXXXXXXXXXXXXXXXXXXXXXXXXXXXXXXXXXXXXXXXXXXXXXXXXXXXXXXXX
