------------------------------------------------------------------------------------------------------------------------------------------------------
------------------------------------------------------------------------------------------------------------------------------------------------------
------------------------------------------------------------------------------------------------------------------------------------------------------
------------------------------------------------------------------------------------------------------------------------------------------------------
------------------------------------------------------------------------------------------------------------------------------------------------------
-------------SSS----------?SSS------------------S----------------------------------------------SSS-----SSS-----------S--------------------------------
------------------------------------------------------------------------------------------------------------------------------------------------------
--------------------------------E---------------------------------------------------------------------------------------------------------------------
-------------SSS--------E------<>-------E-----------------------------------------------------------E-------E-----------------------------E--o--------
----------------------E<>---E--[]------<>--------E------ooo---------Q-------SS---------------------<>------<>--------S-------------------<>-----------
--------------------E<>[]--<>--[]------[]-------<>-------------------------------------------E-----[]------[]--------------E---------E---[]-----------
----B--------------<>[][]--[]--[]------[]-------[]-----------------------------B------------<>-----[]------[]----------------------------[]------B----
----b--------------[][][]--[]--[]------[]-------[]-----------------------------b---------EE-[]-----[]------[]-E-E------------------------[]------b----
XXXXXXXXXXXX----XXXXXXXXXXXXXXXXXXXXXXXXXXXXXXXXXXXXXXXXXXXXXXXXXXXXXXXXXXXXXXXXXXXXXXXXXXXXXXXXXXXXXXXXXXXXXXXXXXXXXXXXXXXXXXXXXXXXXXXXXXXXXXXXXXXXXX
