----------------------------------------------------------------------------------------------------
----------------------------------------------------------------------------------------------------
----------------------------------------------------------------------------------------------------
----------------------------------------------------------------------------------------X-----------
------------------E---------------------------------------------------------------------X-----------
----------------SSSSSS----SSSS-----XX---------------------Q----------XX-----------------X-----------
----------------------------------XXX-----------SS------------------XXX-----------------X-----------
---------------------------------XXXX------------------------------EXXX-----------------X-----------
---------------------------------XXXX-----o----------E--E---------XXXXX-----------------X-----------
----------------SSSS---X-XXXXXX--XXXX---------------<>-<>-?-------XXXXX-S---------------X-XX--------
-----------------------XXXX------XXXX-------------X-[]-[]-------XXXXXXX-----------------X-XX-------B
-----------------------XX--------XXXX------------XXX[]-[]------XXXXXXXX-----------------X-XX-------b
----E---------------E-EX---------XXXX-------E---XXXX[]-[]---EE----XXXXX---E-----X-------X-XX-------B
XXXXXXXXXXXXXXXXXXXXXXXX---XX----XXXXXXXXXXXXXX-XXXXXXXXXXXXXXXXXXXXXXXXXXXXXXXXXXXXXXXXXXXXXXXXXXXX
