------------------------------------------------------------------------------------------------------------------------------------------------------------------
------------------------------------------------------------------------------------------------------------------------------------------------------------------
--------------------------------?---------------------------------------------------------------------------------------------------------------------------------
------------------------------------------------------------------------------------------------------------------------------------------------------------------
------------------------------------------------------------------------------------------------------------------------------------------------------------------
-----------------E-------------------------------S-----------------------------------S------------E-----------------------------------------------SSSS------------
----------------<>-------------------------------------------------------------------------------<>---------------------------------------------------------------
------------E---[]-----------------------------------------------------------------B-------------[]------------X--------------------------------------------------
-----------<>---XXX---------SSSS--------E----------------------------XX------------b-------------XXX----------XX--------------------------------------------------
------SSS--[]--------------------------<>-------------------------X-XXX---------SSSXSS-----------------------XXX-----------------X---------------QQ---------------
---E-------[]-------E------------------[]------------------------XXXXXX-----------------E------------E-------XXX------------E---XX--------------------------------
--<>-------[]------<>------------------[]---X--------------------XXXXXX----------------<>------X----<>-------XXX----------------XX--------------------------------
--[]-------[]------[]------------------[]--XX--------------------XXXXXX-----E----------[]-----XX----[]-------XXX----------------XX-----EEE---------EE---------F---
XXXXXXXXXXXXXXXXXXXXXXXXXXXXXXXXX-XX-XXXXXXXXXXXXXXXX---XXXXXXXXXXXXXX--XXXXXXXXXXXXXXXXXXXXXXXXXXXXXXXXXXXXXXXX-XXXXXXXXXXX-XX-XX---XXXXXXXXXXXXXXXXXXXXXXXXXXXXX
