--------------------
--------------------
--------------------
--------------------
--------------------
--------------------
--------------------
--------------------
--------------------
-------XX-----------
------XXX-----------
------XXX-----------
------XX------E-----
XXXXXXXX---XXXXXXXXX
