--------------------------------------------------
--------------------------------------------------
--------------------------------------------------
--------------------------------------------------
--------------------------------------------------
----------E---------------------------------------
---------<>------------------------XSSS-----------
---------[]-----------------------EXX-------------
---------[]----------------------XXXS-------------
---------XXX--------------------XXXXX-------------
--------------------------------XXXXX-SS----------
----B----------------------B----XXXXX-------------
----b----E-----------------b---EXXXXX-------------
XXXXXXXXXXXX-XX----XXXXX-XXXXXXXXXXXXXX-----XXXXXX
