------------------------------------------------------------------------------------------------------------------------------------------------------
------------------------------------------------------------------------------------------------------------------------------------------------------
---------------------------------------------oo-------------------------------------------------------------------------------------------------------
--------------------------------------?-----XXXX-------------------o----------------------------------------------------------------------------------
-----------------XX-----------------------------------------------XXX-------------------------oo-------------------------------------oo--oo-----------
----------------------------------------------------------------------o------o-o----XXX------XXXX----------------------------oo-----------------------
---------------E----------o----ooo------E--------XXXX--o---o---o------XXXX------------------------o----E---------------XXX------------------------E---
-----------XXXXXX-------------------XXXXXX------------XXX-XXX-XXX--------------------------------XXX--------------------------------------------XXXXXX
--------------------XXX------------------------------------------------------XXXX---------------------------------------------XXX---------------------
--------------------------------XXXX-----ooo--------------------------------------XXX-XXX----------------------EE-E-------------------XXX-------------
-------XXXXX-------------------------------E-----------------------------------------------------o----------XXXXXXXXXXXX------------------------------
-----------------------------------XXXXXXXXXX----------------------------XXXX-------------XXX---XXXXX-------------------------------------XXXX--------
--------------------oo---XXXXXXX-----------------------------E----------------------------------------------------------------------------------------
XXXXX--------------XXX--------------------------------XXXXXXXXXXXXXXXX-----------------------------------XXX------------------------------------------
