----------------------------------------------------------------------------------------------------------------------------------------------------------------------------
----------------------------------------------------------------------------------------------------------------------------------------------------------------------------
----------------------------------------------------------------------------------------------------------------------------------------------------------------------------
----------------------------------------------------------------------------------------------------------------------------------------------------------------------------
----------------------------------------------------------------------------------------------------------------------------------------------------------------------------
-----------------------------SS---------------------------------------------------------------------------S--------------------------------------------------------------XXX
----------------------------------------------------------------------------------XSSS-----------------------------------------------------------------------------------XXX
-------------------------------------o-------------------------------oo----------XXX---------------------------------------------------------XSS--o----------------------XXX
--------------------------------------------------------------------------------XXXS--------------ooo------------------XSS-SQ---------------XXX-----------------------XX-XXX
---------QQ-----------------XXXX--SSS------------------ooo-------XXX------------XXXX------------E---------S-----------XXX------------------XXXX-SS-------------------XXX-XXX
-------------------------XXXXX----------------------------------XXXX----------XXXXXX-SSS-------<>--------------------XXXX-----------------XXXXX---------------------XXXX-XXX
----------------------XXXXXX-----------------------------------XXXXX---------XXXXXXX-----------[]-------------------XXXXX----------------XXXXXX--SSS---------------XXXXX-XXX
-------------------XXXXXXX------------------------------------XXXXXX------------XXXX-----------[]------------------XXXXXX--SSSSS--------XXXXXXX-------------------XXXXXX-XXX
XXXXXXXXXXXXX--XXXXXXXXX------XX--XXXXXXXXXXXXXXXX--XXXXXXXXXXXXXXX---XXXXXXXXXXXXXXXX---XXXXXXXXXXXXXXXXXXXXXXXXXXXXXXX-------XX-XXXXXXXXXXXX------XXXXXXXXX---XXXXXXX--XXX
