--------------------------------------------------------------------------------------------------------------------------------------------------------------------
--------------------------------------------------------------------------------------------------------------------------------------------------------------------
------------------------------------------------------------------------------------------------------------------------------------------------?-------------------
--------------------------------------------------------------------------------------------------------------------------------------------------------------------
--------------------------------------------------------------------------------E-----------------------------------------------------------------------------------
--------------------?SS-----------------------------------------------------SSSSSS----S----------------------------------------SSSSS------------------------------XX
--------------------------------------------------------------------------------------------------------------------------------------------------SS-------------XXX
---------------------------------------------------------B---------------------------------------------------------------------------------------------X--------XXXX
---------------------------------------------------------b-------------------E--------------------------------------------------E-------------SS------XX-------XXXXX
--------------------------------QQQQ-------------------SSXSS----------E----SSSSSSS-----E---------------E-----------------------SSSSS-----------------XXX------XXXXXX
-----------------E---B-----------------B-----E---B-------------------<>---------------<>--------------<>-----E------------E-----------X----B--------XXXX-----XXXXXXX
------------B--------b-------B--E------b---------b-----------B-------[]---------------[]---------B----[]----<>-----B-----<>-----------X----b-------XXXXX----XXXXXXXX
------------b--------B-------b-------------------B-----------b-------[]---------------[]---------b----[]-E--[]-----b-----[]-----------X----B------XXXXXX---XXXXXXXXX
XXXXXXXXXXXXXXXXXXXXXXXXXXXXXXXXXXXXXXXXXXXXXXXXXXXXXXXXXXXXXXXXXX--XXXXXXXXXXXXXXXXXXXXXXXXXXXXXXXXXXXXXXXXXXXXXXXXXXXXXXXXXXXXXXXXXXXXXXXXXXXXX-XXXXXXXXXXXXXXXXXX
