------------------------------------------------------------------------------------------------------------------------------------------------------------------------------------------------------------------
------------------------------------------------------------------------------------------------------------------------------------------------------------------------------------------------------------------
------------------------------------------------------------------------------------------------------------------------------------------------------------------------------------------------------------------
------------------------------------------------------------------------------------------------------------------------------------------------------------------------------------------------------------------
------------------------------------------------------------------------------------------------------------------------------------------------------------------------------------------------------------------
------------------Q--------------------------------------Q-Q-------------------------S-------------------------------------------------------QQQQ---------------------------------------------------------------XX
--------------------------------------------------------------------------------------------------oooo----------oooo------------oooo---------------------------------------------------------------------------XXX
--------------------------------------------------------------------------------------------------------------------------------------------------------------------------------------------------------------XXXX
-----------------------------------oo-------------------------------------------------------------------------E---------------E------------------------------------------------------------------------------XXXXX
---------------E--?---------------o--o-------------------Q-Q-----------------------QQQQ----------------------<>--------------<>------------QQ?SSQQQ---------------------------------------------------------XXXXXX
--------------<>--------------------------------------------------------------------------------X------------[]--------------[]------------------------------E------------------------X--------------------XXXXXXX
--------------[]--------------------------------------------------------------------------------X------------[]--------------[]-----------------------------<>------------------------X-------------------XXXXXXXX
--------------[]--------------------------------------------------------------------------------X------------[]--------------[]-----------------------------[]------------------------X------------------XXXXXXXXX
XXXXXXXXXXXXXXXXXXXXXXXXX--XXXXXXXXXXXXXXXXXXXXXXXXXXXXXXXXXXXXXXXXXXXX----XXXXXXXXXXXXXXXXXXXXXXXXXXXXXXXXXXXXXXXXXXXXXXXXXXXXXXXXXXXXXXXXXXX--XXXXXXXXXXXXXXXXXXXXXXX---XXX--XXXXXXXX--XXXXXXXXXXXXXXXXXXXXXXXXX
