-------------------------------------------------------------------------------------------------------------------------------------------------------------------------------------------------------------------------------------------------------------------------------------------------------------------------------------------------------------------------
-------------------------------------------------------------------------------------------------------------------------------------------------------------------------------------------------------------------------------------------------------------------------------------------------------------------------------------------------------------------------
-------------------------------------------------------------------------------------------------------------------------------------------------------------------------------------------------------------------------------------------------------------------------------------------------------------------------------------------------------------------------
-------------------------------------------------------------------------------------------------------------------------------------------------------------------------------------------------------------------------------------------------------------------------------------------------------------------------------------------------------------------------
------------------------------------------------------------------------------------------------------oo-----------------------------------------------------------------------------------------------------------------------------------------------------------------------------------------------------------------------------------------------------------------
---------------------------------------------------------------------------------------------------------------------------------------------------SSSSSSSS------------------------------------------------------------------------------------------------------------------------------------------------------------------------------------------------------------XX
-----------------------------------------------------------------------------------------------------------------------------------------------------------------------------------------------------------------------------------------------------------------------------------------------------------------------------------------------------------------------XX
------------------------------------------------------------------------------------------------------------------------------------------------------------------------------------------------------------------------------------------------E--------------------------------X-----------------------------------------------------------------------------------X-XX
-----------------------------E---------------------------o------------E--S--------o-----E--o------E------------------------------------------------------------------------------SSSSSSSS-------------------------------oo------------------E--<>-------------------------------XX--oo------o----o-------------------oo---oo-----------------------------------------X-XX
----------------------------<>---------------------------------------<>-----E----------<>--------<>-----------------------------------E-----------X----S----X---------------------------------------------------------------------------E--<>--[]------------------------------XXX----------------------------------------------------------------E----------------X-X-XX
----------------------------[]---------------------------------------[]----<>----------[]--------[]----------E-----------------------<>-----------X------E--X-------E------------------------------------------------------------------<>--[]--[]-----------------------------XXXX---------------------------------------------------------------<>----------E-----X-X-XX
----------------------------[]---------------------------------------[]----[]----------[]--------[]---------<>-----------------------[]-----------X---------X-----------E----------------------------------X---------------------------[]--[]--[]----------------------------XXXXX----------------------X---X------------------------------------[]---------<>---X-X-X-XX
--------------E-EE-------E--[]----E-E---------------E---------EE-E---[]----[]----------[]--------[]-E-EE----[]-E-----E----EE-E-------[]-----E-EE--X---------X------------------------------------------EE--X---------------------EE-E--[]--[]--[]--------EE-E--E---------E--XXXXXX----------------------X-E-X-----------------------E------E-EE--[]---------[]---X-X-X-XX
XXXXXXXXXXXXXXXXXXXXXXXXXXXXXXXXXXXXXXX-X-XX-XX-XX-XXXXXXXXXXXXXXXXXXXXXXXXXXXXXXXXXXXXXXXXXXXXXXXXXXXXXXXXXXXXXXXXXXXXXXXXXXXXXXXXXXXXXXXXXXXXXXXXXXXXXXXXXXXXXXX-X-XX-X-XX-XXXXXXXXXXXXXXXXX-X-X-XXXXXXXXXXXXXXXXXXX------XXXXXXXXXX-XX--XX--XXXXXXXXXXXXXXXXXXXXXXXXXXXXXXXXXXXXXXXXXXXX---XX---XXXXXXXXXXXXXXXX-----X----XXXXXXXXXXXXXXXXXXXXXXXXXXXXXXXXXXX-X-X-X-XX
