------------------------------------------------------------------------------------------------------------------------------------------------------------------------------------------
------------------------------------------------------------------------------------------------------------------------------------------------------------------------------------------
------------------------------------------------------------------------------------------------------------------------------------------------------------------------------------------
------------------------------------------------------------------------------------------------------------------------------------------------------------------------------------------
------------------------------------------------------------------------------------------------------------------------------------------------------------------------------------------
-------------------------------------------------------------------------------------SSS------------------------------------------------------------------------------------------------XX
--------------------------------------------------------------------------------------------------------------------------------------------------------E-------------------------------XX
-------------------------------------------------------------------------------------------------------------------------------------------------------<>-------------------------------XX
-------------------------------------------------------------------------------------------------------------------------------------------------------[]----------------------------X--XX
----------------------------------------E------E-------------------------------E----XXXXX-----------------------------------------------------XSSS-----XX---------------------------XX--XX
---------------------------------------<>-----<>----E--------------------------E----X--------------------------X------------------------------X----------------E-----------E----E--XXX--XX
---------------------------------------[]-----[]------------------------------------X---------------------B----X------------------------------X-----------B---<>-----B------------XXXX----
----------E--E-EE-------EE-E-----E-----[]-----[]-----------EEE------EE-E------------X-------------EE-E----b----X---EE-E--E------E----------E-EX-----------b---[]-----b-----------XXXXX----
XXXXXXXXXXXXXXXXXXXXXXXXXXXXXXXXXXXXXXXXXXXX--XXXXXXXXXXXXXXXXXXXXXXXXXXXXXXXXXXXXXXXXX----XXXXXXXXXXXXXXXXXX--XXXXXXXXXXXXXXXXXXXXXXXXXXXXXXXXXXXX---XXXXXXXXXXXXXXXXXXXXXXXXXXXXXXXXXXXX
