-------------------------------------------------------------------------------------------------------------------------------------------
-------------------------------------------------------------------------------------------------------------------------------------------
--------------------------------oo---------------------------------------------------------------------------------------------------------
------------------------------------E--E---------------------------------------------------------------------------------------------------
---------------------Eooo----------XXXXXXX-------------oooo----------E------------------oo--oo---------------------------------------------
---------------------XXXXX-----------------------------XXXX----------E--E-------oo---------------------------E-----oo--------------------XX
---------------------------------------------oo------------------------XXXXXX------------------------E---------------------XX------------XX
---------------------------------------------------------------------------------------------------XXXXXXXX----------------------------XXXX
------------------------------XXXXX----------------------------------------------XX----------------------------------------------------XXXX
-------------------XXXXXXXX--------------------------------------XXX---------------------XX--------------------XXXX--XXXX------------XXXXXX
--------------------------------------------------XXX-?------------------------------------------------------------------------------XXXXXX
----------------------------o----------------------------------------------------------------XXXX------------------------------------XXXXXX
-------------XXXX----------XXX------------------------------------------------------------------------------ooo------------------E---XXXXXX
XXXXXXXXXXX----------------------------------XXXX-----XXXXX-XXXXX-------------------------------------------XXX-------------XXXXXXXXXXXXXXX
