-------------------------------------------------------------------------------------------------------------------------------------------
-------------------------------------------------------------------------------------------------------------------------------------------
--------------------------------oo---------------------------------------------------------------------------------------------------------
------------------------------------E--E---------------------------------------------------------------------------------------------------
---------------------Eooo----------XXXXXXX-------------oooo----------E------------------oo--oo---------------------------------------------
---------------------XXXXX-----------------------------XXXX----------E--E-------oo---------------------------E-----oo--------------------XX
---------------------------------------------oo------------------------XXXXXX------------------------E---------------------XXX-----------XX
---------------------------------------------------------------------------------------------------XXXXXXXX----------------------------XXXX
------------------------------XXXXX----------------------------------------------XXX---------------------------------------------------XXXX
-------------------XXXXXXXX--------------------------------------XXX---------------------XXX-------------------XXXX--XXXX------------XXXXXX
--------------------------------------------------XXXX?------------------------------------------------------------------------------XXXXXX
----------------------------o----------------------------------------------------------------XXXX------------------------------------XXXXXX
-------------XXXX----------XXX------------------------------------------------------------------------------ooo------------------E---XXXXXX
XXXXXXXXXXX----------------------------------XXXX-----XXXXX-XXXXX-------------------------------------------XXX-------------XXXXXXXXXXXXXXX
