-----------------------------------------------------------------------------------------------------------------------------------------------------------
-----------------------------------------------------------------------------------------------------------------------------------------------------------
-----------------------oo-------------------------------------------------------ooo------------------------------------------------------------------------
--------------------------------------------------Q-----------------------------XXXX-----------------------------------------------------------------oo----
--------------------------------------ooooooo----------XXX-------------------------------------------------------------------------------------------------
-----------------------XXX---------XX-----------------------------XXoo----XX---------------------------------------XXX-----oo--XXXX--------------------XXXX
------------------------------------------------XX------------------------------------------------------------------------XX----------------XXX------------
-----------------------------------------XX---------------------------------------------------------------------------------------------XXX-oo-------------
-------------------------------------------------------------------------------------XXXX------oooo---------------------------------------------XXX--------
----------------XXXX------XXXXX-----------------------------XXXXXX----XX-----XX-----------------------XXXXXX-----------------XX---XXXXX--------------------
--------------------------------------------------------------------------------XXXXXX---------------------------------------------------------------------
--------------------------------------------XXXXX----------------------------------------------------------------------------------------------------------
-----------------------------------------------------------------------------------------------------------------------------------------------------------
XXXXXXXXXXX--XXXX--XXXX---------XXXX--XXXX----------------------------------------------XXXXXXXXX-XXXX------XXXXXX----XXXX-----XXXX------------------------
