------------------------------------------------------------------------------------------------------------------------------------------X-
-------------X---------------------------------------------------X--<>--------X-----------------------XX------------------------------------
--------------------------------------------------------------SSX---[]------------X--------------------------E--------------------X------X--
--XX--------X----------------XX-------XX----------------------------XXE-----------------------X--------------E------------------------------
--------------------------------------X--X-----X----------------------------------------------X---------------------------------------------
S-------------------oSX----------------------------------------------------o-----------------------------o---------ooX----SS----------------
-------------------------------------SX-------SX-----------X--------------------------------------------S-----------------------------------
----------------------------------X---------o--------E--------------------------------------------------X-----------------------------------
XS-XSE------------------------------------SXXX------------------------------------X---------------------------------------------------------
S-------------------X------------S?------------------------X--------------------------------------------------------E-X---------------------
XX------------------X---XX-----XXXXXX---------------------------------------<>--------------------------------------------------------------
--------XX------------------------------------------------------------------[]XXX-----------------------------------------------------------
-------------------------------------SXX------------------XX-----X-------X--XX----------------------------------------XX-----------------F--
XXXXXXXXXX-------------E-E-----XX----XX-------X--XXSB--XXXXX----------SX-XXXXX--XX-----X-----XX--XX-------------X-----------------oE--XXXXXX
