-----------------------------------------------------------------------------------------------------------------------------------------------------------Q-S------------SE-----------------E----------
--------------------------------------------E-----------------------------------------------------------S----------------------B----------------------------------------------------------XX------------
------------SE------------------------QXE-----------E---------------------------------------------------------------------------------------------------------------------------------------------------
---------------------------------------------------------------------------E---------S------------------------------------------------------------------------------------------------------------------
----------------------------------------------------------Q---------------------------------------------------------------------------------------------------------------------------------------------
--SSB-----------b---S---------------------------------------------------------------?------------------------------------------------------------------------------------------------------------------E
---------------X----------------------------------------------?-----------------------So----------------------S-----------------------------------------------------------------------------------------
SX----------S------------------------------------S------------Xo----------------------E-----------------------------S?------------------------X----E----------------------------------------------------
--------QX-----------------------------------------------------------------------------------------S-----------------E-------------------------------------------------------------S--------------------
--------E------------------------------------------------------------------------------------------------------------------------------------------------------------------------------S----------------
-------------------------------------------------------------------------------------------N------------------------------------------------------------------------------------------------------------
---------------------------------X-----E----S--------------------------------------------------------------------------S--B-------------XX-----------------b---Q-----------------------o----------------
--E----------S-QX---E--QXXXXXX--------E-B----SXXX--N-------<>XXEE-----------E----------SXXX-------------------oXXXXXSXXXXXXXXXXXX-E---XXXX---XXXXXXX----?oXX--<>-----EXXX---E--------SXX<>XXXXX------F--
XXXXXXXXXXXXXXXXXXXXXXEXXXXXXXXXXXXXXXXXXXXXXXXXB--X-XXXXXX[]XXXXXXXXXXXXXXXXXXXXXXXXXXXXXXX--XXXXXXXXXXXXXXXXXXXXXXXXXXXXXXXXXXbXXXXXXXXX---XXXXXXX-----XXXXX[]XXXSXXXXX-XXXXXXXXXXXXXX[]XXXXX--SXXXXXX
