--So----------------------------oSSXXXXX--------------SS--------XX--------------------------------------------------------------------------------------------------------
--E--------o---------------------------------------------------XXXXX---------------------------------------------------------------------------------------------E--------
---------X-----------------------------------------------------SSQS-------------------------------------------------------------------------------------------------------
---------XX---------------------------------------------------------------------------------------------------------------------------------------------------------------
------------------------------------------------------------------------------------------------------------------------E-------------------------------------------------
----------------------------------------------------------------So-------XX---------------------------------S-------------------------------------------------------------
----------<---------------------------------------------------------------------------------------------------------------------------------------------------------------
-----------------X-----------------------<>S-------------------------------------------------------------------oS---------------------------------------------SS----------
----------X------X----------------------S[]Q--------b---------------------------------------------------------------------------------------------------------------------
---------<>-----XX--------------------<>S-XX-------<>-SS-------------------------------------------------S<>-----XXXXXXXE----------XXX--------------------------S---------
--------S[]XSBXXX------------------oSS[]XXXE-------[]------------------------------XXXXXXXXXX-------------[]-E---XXXXXXXXX-------SSXXXX-----------------------------------
----XXXXXXXXXXX----------SSS-XXXXXXXXXXXXXX-----oSS[]S----E-X--XX-----------------XXXXXXXXXXX------------S[]XXXXXXXXXXXXXXX-----X--------------?XE------------------------
--XXXXXXXXXXXXXXXX-------b--XXXXXXXXXXXXXXXXXXXXXXXXXXXXXXXXXXXX-------E-X------oXXX-XXXXXXE-----------XXXXXXXXXXXXXXXXXX------QB-------------S-XX--------------------F---
-XXXXXXXXXXXXXXXXXXXXXXXXXXXXXXXXXXXXXXXXXXXXXXXXXXXXXXXXXXXXXXX--XXXXXXXX------XXXXXXXXXXXXX-XXX---XXXXXXXXXXXXXXXXXXXX-----XXXXX---o------XXXXXXXXXXE-----------XXXXXXXX
