--------------------------------------------------------------------------------------------------------------
S----QQ-------------------------------------------------------------------------------------------------------
SSSSS?S---------------------------o--------------------------------------------------XX-----------------------
---------------------o-------------------------E--------------------------------------------------------------
------------------------------------------------------------SSSE----------------------------------------------
-----------------------------------------------------------SSSSS----------------------------------------------
--------------------------------------------------------------------------------------------------------------
-------------------------E---E--------------------------------------------------------------------------------
--------------------------------------------------------------------------------------------------------------
--------S-------------------------------------------------------X---------------------------------------SS----
oXXX----XXXXX---------------------------------bQSSQE---------------------------E--------------------E---S-----
--------XXX-----<>--------------------------XXXS----------------<>-----oQS-----E-----XXXX---------------------
--------XXXXXX--[]E-----QSSS-XXXXXXE----XXXXXXXXX---------XXXXXX[]X---XX---XXXXXXXXXXXX-------------------F---
XXXXXXXXXXXXXXXXXXXXXXXXXXXXXXXXXXXXXXXXXXXXXXXXXX----XXXXXXXXXXXXXXXXXXXXXXXXXXXXXXX--------XXXXXXXXXXXXXXXXX
