--------------------------------------------------------------------------------
------------------------------XXX-----------------------------------------------
--------------------------------------------------------------------------------
--------------------------------------------------------------------------------
--------------------------------------------------------------------------------
-------------------------------------------------XXX----------------------------
-------------------------------------------------XX-----------------------------
-----------------------------------------------EXXXXXX--------------------------
--------------------------------oSSSo----------XXXXXX---------------------------
--------------------------------------------XXXXXXXXX-E-------------------------
------------------------------E------------XXXXXXXXXXXXXX-X-------------F-------
-------------XXXXXX-X------------------XXXXXXXXXXXXXXXXXXXX---------XXXXXXXXXXXX
-----------XXXXXXXXXX----------------oXXXXXXXXXXXXXXXXXXXXX-----XXXXXXXXXXXXXXXX
-X-------XXXXXXXXXXXXE--------XXXXXXXXXXXXXXXXXXXXXXXXXXXXX-XXXXXXXXXXXXXXXXXXXX
